Spidergawd - The Grand Slam
The Hooters - All You Zombies
Journey - Wheel In the Sky
Oasis - Whatever
Whitesnake - Fool for Your Loving
Toto - Africa
Airbourne - No Way But the Hard Way
Elton John - Saturday Night's Alright for Fighting
Krokus - Bad Boys, Rag Dolls
Kansas - Carry On Wayward Son
Jelly Roll - The Lost
Philip Bailey & Phil Collins - Easy Lover
The Lazys - Hot Under The Collar
H-Blockx vs. Dr. Ring-Ding - Ring of Fire
Neil Young - Rockin' In the Free World
Måneskin - HONEY (ARE U COMING?)
The Commoners - Just Watch Me
Don Henley - The Boys of Summer
Ghost - Square Hammer
Billy Morrison & Ozzy Osbourne - Gods Of Rock N Roll (feat. Steve Stevens)
U2 - Angel of Harlem
Kings of Leon - Use Somebody
Deaf Havana - Carousel
Nazareth - Dream On
Billy Talent - Fallen Leaves
Green Day - Basket Case
Rose Tattoo - Rock 'N' Roll Outlaw
Placebo - Special K
REO Speedwagon - Keep On Loving You
Takida - What About Me?
Weezer - Buddy Holly
David Bowie - Let's Dance
LEAP - Exit Signs
3 Doors Down - Kryptonite
John Cougar - Jack & Diane
Kraftklub - Songs für Liam
Scorpions - Rock You Like a Hurricane
Sabaton - Crossing the Rubicon
Nirvana - Lithium
Loverboy - Turn Me Loose
John Diva & The Rockets of Love - God Made Radio
Foo Fighters - Asking For A Friend
Mötley Crüe - Wild Side
Mando Diao - God Knows
Ram Jam - Black Betty
Jimmy Eat World - All The Way
Whitesnake - Now You're Gone
AC/DC - Rock 'N' Roll Damnation
The Black Crowes - Profane Prophecy
The Police - Every Breath You Take
Garbage - Only Happy When It Rains
Van Halen - Love Walks In
Goodbye June - Anywhere the Wind Blows
Queen - The Show Must Go On
Cold Years - 62 (My Generation’s Falling Apart)
Rory Gallagher - Shadow Play
Vance Joy - Riptide
All Time Low - The Weather
Bon Jovi - You Give Love a Bad Name
Biffy Clyro - Opposite
R.E.M. - It's the End of the World As We Know It (And I Feel Fine)
Shinedown - Killing Fields
Bruce Springsteen - Dancing in the Dark
Nickelback - If Today Was Your Last Day
Ugly Kid Joe - Everything About You
Slash & Brian Johnson - Killing Floor
Free - All Right Now
The Gems - Year Of The Snake
Green Day - When I Come Around
REO Speedwagon - Can't Fight This Feeling
Alter Bridge - Playing Aces
Skunk Anansie - Hedonism (Just Because You Feel Good)
Iron Maiden - The Trooper
Beatsteaks - Hand In Hand
Poison - Talk Dirty to Me
Massive Wagons - Everywhere We Go
Radiohead - Creep
Papa Roach - Last Resort
BAP - Verdamp Lang Her
Nestor - In The Name Of Rock'n'Roll
Lansdowne - Burn It Down
Billy Idol - Eyes Without a Face
Red Hot Chili Peppers - Can't Stop
Steve Miller Band - Jet Airliner
Weezer - Hero
Gary Moore - Friday On My Mind
Volbeat - Still Counting
38 Special - Caught Up In You
The Glorious Sons - S.O.S. (Sawed Off Shotgun)
Mike Oldfield & Roger Chapman - Shadow On The Wall
Foo Fighters - Wheels
The Sisters of Mercy - Temple of Love 1983)
Guns N' Roses - Nothin'
Rise Against - House On Fire
Die Ärzte - Westerland
Alice Cooper - Feed My Frankenstein
Aerosmith & YUNGBLUD - Wild Woman
Derek & The Dominos - Layla
LINKIN PARK - Breaking the Habit
INXS & Jimmy Barnes - Good Times
The Black Crowes - Hard To Handle
Ghost & Joe Elliott of Def Leppard - Spillways
Bryan Adams - One Night Love Affair
Chad Kroeger - Hero (feat Josey Scott)
Asia - Don't Cry
Social Distortion - Don't Drag Me Down
Cinderella - Gypsy Road
Joyce Manor - Well, Whatever It Was
Bachman-Turner Overdrive - Take It Like a Man
Biffy Clyro - The Captain
Twisted Sister - We're Not Gonna Take It
Seether - What Would You Do? (feat. Gavin Rossdale)
Bloodhound Gang - Along Comes Mary
Fall Out Boy - Thnks fr th Mmrs
Queen - Crazy Little Thing Called Love
Rush - The Spirit of Radio
Cold Years - Night Like This
Journey - Ask the Lonely
Muse - Starlight
Thunder - Dirty Love
Yellowcard - Bedroom Posters
Kissin' Dynamite - The Devil Is A Woman
Ramones - Pet Sematary
Metallica - Turn the Page
Paul McCartney & Wings - Jet
Jet - Are You Gonna Be My Girl
Westernhagen - Geiler is schon (Live - Live in Dortmund 1989)
