Tasmin Archer - Sleeping satellite
Huey Lewis & The News - Stuck with you
Taylor Swift - Shake it off
The Doobie Brothers - Listen to the music
Donna Summer - She works hard for the money
Gary Barlow - Let me go
The Bee Gees - Alone
Enya - Orinoco flow (Sail away)
Eros Ramazzotti - Quanto amore sei
Smokie - Lay back in the arms of someone
Adele - Someone like you
Yvonne Elliman - If I can't have you
Sixpence None The Richer - Kiss me
Europe - Carrie
Charlie Puth feat. Meghan Trainor - Marvin Gaye
Barry White - You're the first, the last, my everything
U2 - With or without you
Madonna - The power of good-bye
Owen Paul - My favourite waste of time
Whitesnake - Here I go again
Andru Donalds - Mishale (Michelle)
Patti Smith Group - Frederick
Robbie Williams - Advertising space
Foreigner - Urgent
Jennifer Lopez - Waiting for tonight
Pet Shop Boys - Heart
Whitney Houston - I wanna dance with somebody (who loves me)
Israel Kamakawiwo'ole - Somewhere over the rainbow / What a wonderful world
Rita Coolidge - Your love has lifted me(higher and higher)
Chicago - Hard to say I'm sorry
Miley Cyrus - Flowers
Camouflage - The great commandment
Phil Collins - Can't stop loving you
Simply Red - Fairground
Sade - Smooth operator
Uncle Kracker - Follow me
T. Rex - Ride a white swan
Olly Murs feat. Demi Lovato - Up
Roxy Music - Oh yeah!
Culture Club - Karma chameleon
Janis Joplin - Me and Bobby McGee
Faith Hill - This kiss
Chris DeBurgh - Ship to shore
Marlon Roudette - New age
Carole King - Hard Rock Cafe
a-ha - Hunting high and low
Maroon 5 - She will be loved
Bangles - Manic Monday
Men Without Hats - The safety dance
Natalie Imbruglia - Torn
Albert Hammond - The Free Electric Band
Billy Joel - Leningrad
Katy Perry - Hot'n'cold
The Stranglers - Always the sun
CÃ©line Dion - A new day has come
Orchestral Manoeuvres In The Dark - Forever live and die
Melanie Thornton - Love how you love me
Supertramp - The logical song
Elton John - Sad songs (Say so much)
LP - Lost on you
Steve Winwood - Valerie
Michael Jackson - Heal the world
Tom Jones - Sex bomb (Sexbomb)
Cher - The shoop shoop song ( It's in his kiss )
KKsings - If God was a Girl
ABBA - Take a chance on me
Lukas Graham - 7 years
38 Special - Second chance
Irene Cara - Fame
Spice Girls - Wannabe
