Ofenbach feat. Norma Jean Martine - Overdrive
Miley Cyrus - Malibu
Rea Garvey - Take this heart
Sonique - Sky
Katseye - Gabriela
Spliff - Carbonara
Lewis Capaldi - Forget me
Maroon 5 x Lisa - Priceless
FUN. - Some nights
Michael Patrick Kelly - Run Free
Christina Aguilera - Come on over baby (all I want is you)
Jax Jones x Zoe Wees - Never be lonely
Roxette - Sleeping in my car
Shawn Mendes - Why why why
David Guetta x Teddy Swims x Tones And I - Gone gone gone
Daughtry - Over you
WizTheMc - Show me love
Portugal. The Man - Feel it still
Emilia - Big big world
Apache 207 - Morgen
Tate McRae - Greedy
Glass Animals - Heat waves
Myles Smith - Stay (if you wanna dance)
Sia - Never give up
Twenty One Pilots - Level of concern
Madonna - Into the groove
Marc Atlas - Fool
Bleu Soleil & Luiza - Soleil bleu
Lily Allen - The fear
Coldplay feat. Little Simz, Burna Boy, Elyanna & Tini - We pray
Lady Gaga - The dead dance
Benson Boone - Beautiful things
Bomfunk MC's - Freestyler
OneRepublic - Run
Tove Lo - Cool girl
Kaffkiez - Hast du noch Zeit
Stefanie Heinzmann - Good
Purple Disco Machine X Sophie And The Giants - In the dark
Blue feat. Elton John - Sorry seems to be the hardest word
Taylor Swift - The fate of Ophelia
Jason Derulo - If I'm lucky
David Bowie - Modern love
Sienna Spiro - Die on this hill
Tim Bendzko - Hoch
Felix Jaehn x JHart - Pride
Bon Jovi - Because we can
Ray Dalton - Blood running
Delta Goodrem - Lost without you
The Weeknd - Dancing in the flames
Milky Chance - Camouflage
Mr. Probz - Waves
Katy Perry - Bandaids
Jupiter Jones - Still
Post Malone - Chemical
Salt 'n' Pepa - Let's talk about sex
Lost Frequencies X Elley Duhé X X Ambassadors - Back to you
Justin Timberlake - Rock your body
Alex Warren - Eternity
sombr - 12 to 12
Thirty Seconds To Mars - Seasons
Die Fantastischen Vier - Der Picknicker
Lena - Looking for love
Empire Of The Sun - We are the people
Gracie Abrams - That's so true
Argyle - Divine
Shouse - Love tonight
The Script - Breakeven
Nico Santos - All time high
Walking On Cars - Speeding cars
Shannon - Let the music play
Riku Rajamaa - Better off with love
CYRIL - Stumblin' in
Michael Schulte - Broken sunshine
Jax Jones feat. Ina Wroldsen - Breathe
Lewis Capaldi - Almost
Kamrad - I believe
RAYE - Where is my husband!
OPM - Heaven is a halfpipe
Sabrina Carpenter - Manchild
Glockenbach x Tom Walker - Home
Jessie J - Nobody's perfect
Pet Shop Boys - Can you forgive her?
Ed Sheeran - Drive
Olivia Dean - Man I need
Sam Smith - Diamonds
Daniel Merriweather - Impossible
Leony - Don't worry
Revolverheld - Mit dir chilln
Cat Burns - Know that you're not alone
Purple Disco Machine feat. Moss Kena & The Knocks - Fireworks
Seal - Kiss from a rose
Loi - Red eyes
ClockClock - Someday soon
Shawn Mendes - Mercy
Twocolors - Lovefool
Soul II Soul - Back to life (However do you want me)
Mark Forster - Beste
Avicii - Addicted to you
Mark Ambor - Closer to me
Djo - End of beginning
Sophie And The Giants - Shut up and dance
Nickelback - If today was your last day
WizTheMc - At the party
P!nk - Never gonna not dance again
Oasis - Little by little
Huntr/x - Golden
Loud Luxury feat. Brando - Body
Aerosmith - Amazing
Coldplay - Higher power
Isaak - Paper plane
Gigi d'Agostino - La passion
Zara Larsson - Memory lane
Álvaro Soler - Sofia
Taylor Swift - Opalite
Ásdís - Flashback
Queen - I want to break free
Saint Clara - Breakup glow
Paul Kalkbrenner feat. Fritz Kalkbrenner - Sky and sand
Felix Jaehn & Shouse - Walk with me
Manic Street Preachers - If you tolerate this your children will be next
Max Giesinger - Du wärst es gewesen
The Avener - Fade out lines
Chanin - Whisper
U2 - Beautiful day
Alex Warren - Ordinary
Beats International - Dub be good to me (Just be good to me)
Linkin Park - One more light
Alice Merton - Ignorance is bliss
Topic x A7S - Out my head
Imagine Dragons x J.I.D - Enemy
B.o.B feat. Hayley Williams - Airplanes
JoJo - Leave (get out)
Provinz - Glaubst du
Daniel Powter - Bad day
